Item	Category
“Προσωπικές, φυλετικές και λογοτεχνικές επιλογές του Τζαίημς Τζόνσον”  – Δοκίμιο του Γεωργίου Νικ. Σχορετσανίτη	essay
«Οι θεματικές συλλογές 1905-1915 & 1916-1918 του Κ.Π. Καβάφη»  – Μελέτη της Στέλλας Κουτσογιάννη 	essay
«Ο κινεζικός γραπτός χαρακτήρας ως µέσον ποίησης»  – Δοκίμιο του Έρνεστ Φενολλόσα 	essay
 «Περί ζωής» – Δοκίμιο του Πέρσυ Μπυς Σέλεϋ 	essay
«Ποίηση & Παγκοσμιοποίηση» – Συλλογή του Γιώργου Μπλάνα 	essay
«Σημεία και τέρατα / Παγκόσμια εγκυκλοπαίδεια των τεράτων»  – Συλλογή του Γιώργου Μπλάνα 	essay
«Vortex» – Δοκίμιο του Έζρα Πάουντ	essay
«Μια ανασκόπηση» – Συλλογή δοκιμίων του Έζρα Πάουν	essay
«Θέσεις για τον Φοϋερμπαχ» – Δοκίμιο του Καρλ Μαρξ	essay
“H Μεταβυζαντινή Ελληνόφωνη Ποίηση και οι τάσεις της, τα τελευταία 50 χρόνια”  – Δοκίμιο του Κώστα Σοφιανού 	essay
“Ε7τά σημειώσεις για την ποίηση” – Δοκίμιο του Μιχάλη Πιερή 	essay
“Μελέτες (2004-2017)” – Συλλογή του Ευάγγελου Ι. Τζάνου	essay
“Ιταλικός και Ρωσικός Λογοτεχνικός Φουτουρισμός: Συγκλίσεις και αποκλίσεις”  – Μελέτη του Χρίστου Αλεξανδρίδη 	essay
“Κείμενα για τον CHE” – Συλλογή κειμένων του Νικόλαου Μόττα 	essay
“Το Λεξικό του Ηγέτη” – 100 λέξεις	essay
“Ο Νόμος των διαφορετικών λέξεων” – Δοκίμιο του Τάκη Κουφόπουλου 	essay
“Γλώσσα και Γραφή” – Δοκίμιο του Τάκη Κουφόπουλου	essay
“Συγκριτικά στοιχεία της Ελληνικής γλώσσας” – Δοκίμιο του Τάκη Κουφόπουλου 	essay
“Ο Σκοτεινός / Σημειώσεις για τον Ηράκλειτο” – Δοκίμιο του Τάκη Κουφόπουλου 	essay
“Από το χαρτί στην οθόνη: Ζητήματα της ηλεκτρονικής λογοτεχνίας”  – Μελέτη της Μαρίας Μπεχλιβάνου 	essay
“Ιστορική ορθογραφία: αναγκαίο κακό ή άταφος νεκρός;”  – Δοκίμιο του Δημήτρη Καλαμπούκα 	essay
“Η επερχόμενη πείνα” – Δοκίμιο του Θανάση Τριαρίδη	essay
“Το νομικό καθεστώς της παιδικής ηλικίας και της νεότητας (1833-1900)”	essay
“Μικροψυχολογία” – Δοκίμιο των Νίκου Ρούσσου & Θοδωρή Δρούλια 	essay
“Οι μεγάλοι -ισμοί” – Μελέτη του Οδυσσέα Γκιλή	essay
 “Η Τραγωδία του Ευρώ” – Δοκίμιο του Philipp Bagus 	essay
“H δυσπιστία στο έντυπο βιβλίο και η παράλληλη χρήση του χειρόγραφου”  – Δοκίμιο του Τριαντάφυλλου Σκλαβενίτη	essay
“Λέσχες Ανάγνωσης – Μιλάμε για βιβλία…” – Εγχειρίδιο	manual
“Τα ΜΜΕ σαν καθρέφτης της κοινωνίας” – Κείμενα του Noam Chomsky 	essay
“Ο δικός μου Νίκος Καζαντζάκης” – Δοκίμιο του Μπάμπη Δερμιτζάκη 	essay
“Καρυωτάκης” – Χρονοθραύσματα 30 του Βασίλη Λαλιώτη	essay
“Μικρά Αποσπάσματα για την Αυτονομία” – Δοκίμια του Κορνήλιου Καστοριάδη 	essay
“Μεγάλη επιστήμη – ενδιαφέρουσες ζωές” – Δοκίμιο του Στέφανου Τραχανά 	essay
“Το τέλος της τέχνης στον Αντόρνο και τον Ντεμπόρ” – Δοκίμιο του Anselm Jappe 	essay
“Φίλων Σοφίες” – 203 αποφθέγματα // Συλλογικό έργο	essay
“Γραφτή και Δημοτική και το Γλωσσικό Ζήτημα στην Ελλάδα”  – Δοκίμιο του Karl Brugman 	essay
“Οδηγός γλωσσικής επιμέλειας για συγγραφείς”	manual
 “Το Ομότιμο Μανιφέστο” – Δοκίμιο του Βασίλη Κωστάκη 	essay
“Η ομότιμη προοπτική” – Πέρα από το κράτος και την αγορά	essay
“Γράφοντας μετά τη σιωπή” – Ενισχύοντας τις δεξιότητες αυτοβιογραφικής γραφής  ως μέσο στήριξης γυναικών που επέζησαν της έμφυλης βίας 	manual
“Η Λογοτεχνία στα νέα περιβάλλοντα των ΤΠΕ” – Δοκίμιο της Βενετίας Αποστολίδου 	essay
“50 κείμενα για την κρίση” – Συλλογικό έργο	essay
“Η Επανάσταση στη Ροζάβα” – Δοκίμιο των Μίχαελ Κναπ,  Άνγια Φλαχ και Ερτζάν Αϊμπογά	essay
“​Φροντίδα, χειρισμός και τεκμηρίωση αρχειακού υλικού στο Ιστορικό  Αρχείο της Εθνικής Τράπεζας” 	manual
“Κείμενα από το Διεθνές Συνέδριο για τη Ρωσική Επανάσταση” 	essay
“Εριστική Διαλεκτική του Σοπενχάουερ – Η τέχνη του Διαλόγου ως Εργαλείο  του Ηγέτη” – Δοκίμιο του Σωτήρη Μαργώνη 	essay
“Αίας” – Δοκίμιο για τη ρουτίνα του Δήμου Χλωπτσιούδη	essay
“Η Δημιουργική Καταστροφή στον Καπιταλισμό” – Δοκίμιο του Γιόζεφ Σουμπέτερ	essay
“Οι γυναίκες στην Ισπανική Επανάσταση” – Δοκίμιο των Μάρτα Άκελσμπερνκ,  Τέμμα Καπλάν, Λιζ Ουίλλιζ 	essay
“Μικρή εισαγωγή στην ποίηση του Paul Celan” – Δοκίμιο της Ιωάννας Αβραμίδου 	essay
“Gustave Flaubert – βιβλιοκριτικές” – Συλλογή του Μπάμπη Δερμιτζάκη 	essay
“Αντιπελάργησις”- Δοκίμιο του Βασίλη Λαλιώτη	essay
“Μίκης Θεοδωράκης: Διάλογοι στο λυκόφως” – Συνοπτική παρουσίαση της  Αναστασίας Βούλγαρη 	essay
“Γιάννης Ρίτσος (1909-2009) – Στους ποιητές αρμόζουν μόνο γενέθλια” 	poem
“Η τριλογία του πολέμου” – Δοκίμιο του Δημήτρη Γληνού	essay
“Η λαϊκότητα της κρητικής λογοτεχνίας” – Δοκίμιο του Μπάμπη Δερμιτζάκη	essay
“Αναλφάβητοι Αναγνώστες” – Δοκίμιο του Βαγγέλη Ιντζίδη	essay
“Ο υπερδρόμος της Βορείου Ευβοίας και η ελεγεία της χαμένης πορείας” –  Δοκίμιο του Δημήτρη Μπαρσάκη 	essay
 “Η κοινωνία του ελέγχου” – Δοκίμιο του Gilles Deleuze 	essay
 “Αυτονομίες και χειραφετήσεις” – Δοκίμιο του Raul Zibechi 	essay
“Για μια κριτική της βίας” – Δοκίμιο του Walter Benjamin	essay
“Γράμματα από την Ιταλία” – Συλλογή του Μιχαήλ Μπακούνιν 	essay
“Θέσεις για τη φιλοσοφία της Ιστορίας” – Δοκίμιο του Walter Benjamin 	essay
“Η Πρωταπριλιά στην ελληνική δημοσιογραφία” – Δοκίμιο του Μπάμπη Άννινου 	essay
“Ο ΙΧ άνθρωπος και οι υποθαλάσσιες αρτηρίες του” – Δοκίμιο του Κώστα Δημητρίου 	essay
 “Η μηχανή της σάρκας” – Δοκίμιο των Critical Art Ensemble 	essay
 “Περί κενών δαιμονίων” – Ομάδα Αυτομόρφωσης ενάντια  στη Βιοτεχνολογία της Κυριαρχίας 	essay
“Καταπονημένες δυνάμεις” – Δοκίμιο από την Ομάδα RETORT 	essay
“Κείμενα για την εργασία και την κρίση” – Δοκίμιο των Gruppe Krisis,  Norbert Trenkle, Anselm Jappe 	essay
“Ο Κάλιμπαν και η μάγισσα – Γυναίκες, σώμα και πρωταρχική συσσώρευση” –  Δοκίμιο της Silvia Federici 	essay
“Κοινά, περιφράξεις και κρίσεις” – Δοκίμιο του Massimo de Angelis 	essay
“Γράμμα στα παιδιά μου και στα παιδιά του κόσμου που έρχεται” –  Δοκίμιο του Raoul Vaneigem 	essay
“Όλα όσα θέλατε να μάθετε για τις ελληνογερμανικές σχέσεις στην κρίση,  αλλά δεν τολμάνε να σας πουν” – Δοκίμιο του Stephan Kaufmann 	essay
“Η Χρυσή Αυγή μπροστά στη δικαιοσύνη” – Δοκίμιο του Δημήτρη Ψαρρά 	essay
“Το ‘γερμανικό εργασιακό θαύμα’ – Μοντέλο για την Ευρώπη;” 	essay
“Διατλαντική Εταιρική Σχέση Εμπορίου και Επενδύσεων (TTIP)” 	essay
“Η μετανάστευση στην Ελλάδα” – Έντεκα μύθοι και περισσότερες αλήθειες 	essay
“5 χρόνια κρίσης του Ευρώ” – Πλάνες, συμφέροντα και κερδισμένοι 	essay
“Η λογοκρισία στην Ελλάδα” – Συλλογικό έργο	essay
“Οι αδελφοί Σούτσοι και η πολιτική ποίησις επί Όθωνος” –  Δοκίμιο του Γ. Τσοκόπουλου 	essay
 “Ιούλιος Τυπάλδος” – Δοκίμιο του Κωστή Παλαμά 	essay
 “Ο Σολωμός και η Ζάκυνθος” – Δοκίμιο του Αντωνίου Μάτεση 	essay
 “Βιζυηνός και Κρυστάλλης” – Δοκίμιο του Κωστή Παλαμά 	essay
 “Γεώργιος Τερτσέτης” – Δοκίμιο του Διονυσίου Στεφάνου 	essay
 “Βαλκάνια και Βλάχοι” – Δοκίμιο του Αχιλλέα Γ. Λαζάρου 	essay
 “Νεοελληνικά υστερόγραφα” – Δέκα μελέτες νεοελληνικής φιλολογίας του  Κ. Μητσάκη 	essay
 “Ανδρέας Λασκαράτος” – Δοκίμιο του Ιωάννου Ζερβού 	essay
 “Πολυλάς, Μαρκοράς και η Σχολή της Κέρκυρας” – Δοκίμιο του Θ. Βελλιανίτου 	essay
 “Τι μας οφείλει η αρχαιότητα” – Δοκίμιο του Παναγιώτη Γ. Νικολόπουλου 	essay
“Οι Γλώσσες του Κόσμου, οι Κόσμοι της Γλώσσας” – Δοκίμιο του Αλέξη Καρπούζου 	essay
“Εισαγωγή στην Κατανοητική Φιλοσοφία” – Δοκίμιο του Αλέξη Καρπούζου 	essay
 “Αφύπνιση της κοσμικής συνείδησης” – Δοκίμιο του Αλέξη Καρπούζου 	essay
“Πενήντα χρόνια ποιητής, πενήντα χρόνια ασκητής” – Δοκίμιο του Μιχάλη Α. Μελετίου	essay
“Η ελληνική ως δεύτερη γλώσσα: Καθορισμός επιπέδων γλωσσομάθειας του  προφορικού λόγου αλλοδαπών μαθητών” 	manual
“Κλειδιά και αντικλείδια: Ταυτότητες και λογοτεχνία στο σχολείο” 	manual
 “Κλειδιά και αντικλείδια: Ανάγνωση και ετερότητα” 	manual
“Δημιουργική γραφή”	manual
“Έντυπη ενημέρωση” – Κριτική ανάγνωση εφημερίδων	manual
 “Λογοτεχνία: Έλληνες και Ξένοι Λογοτέχνες” 	manual
 “Η Δικτατορία των ειδώλων” – Δοκίμιο του Κώστα Χατζιδάκη 	essay
 “Κράτος και Επανάσταση” του Βλαντίμιρ Ιλίτς Λένιν 	essay
 “Ανατομία του Κράτους” – Δοκίμιο του Murray Rothbard 	essay
 “Οι μυθοσυλλέκτες” – Δοκίμιο του Γιάννη Αντάμη 	essay
 “Διαμαρτύρομαι” – Δοκίμιο του Δημητρίου Σωνίτη 	essay
 «Κείμενα για τον Μαρξ» – Δοκίμιο του Φρίντριχ Ένγκελς 	essay
 “Ο καρκίνος δεν είναι αήττητος” – Δοκίμιο του Ζήση Κατσαρίκα 	essay
 «Προς μία ανθρωπολογία της ανοσολογίας – Το σώμα ως έθνος-κράτος» –  Δοκίμιο της Emily Martin 	essay
 “Διαφήμιση και γυναικείο σώμα” – Συλλογικό έργο 	essay
 “Δύο κείμενα για το ποδόσφαιρο” – Συλλογικό έργο 	essay
 “Οικονομική κρίση & αυτοοργάνωση” – Συλλογικό έργο 	essay
 “Επισφαλής Ραψωδία” – Δοκίμιο του Franco «Bifo» Berardi 	essay
 “Το ξεκίνημα της Ιστορίας” – Δοκίμιο του Massimo de Angelis 	essay
 “10 συνεντεύξεις του Κορνήλιου Καστοριάδη” 	essay
 “Η Δίωξη των Χάκερ” – Δοκίμιο του Bruce Sterling 	essay
 “CosmoWave” – Δοκίμιο του Νίκου Βλαντή 	essay
 “Νέα Γενιά” – Δοκίμιο του Αρχοντή Χρυσουλά 	essay
 “Αθιβολές” – Δοκίμιο / Μαρτυρία του Μανώλη Παπαδάκη 	essay
“Ο Μπέρτραντ Ράσσελ και η μετεμφυλιακή Ελλάδα” –  Δοκίμιο του Γιώργου Καλπαδάκη	essay
 “Ξαναπιάνοντας το νήμα” – Δοκίμιο του Γιώργου Λιερού 	essay
 “Τα κερασάκια” – Προτάσεις σοφίας του Στέλιου Κερασίδη 	essay
 “Πλωτίνος Ροδοκανάκης – Ένας Έλληνας Αναρχικός” – Βιογραφία  του Τέου Ρόμβου 	essay
 “Ερρίκος Ίψεν” – Δοκίμιο του Γεωργίου Βιζυηνού 	essay
 “Σκέπτινγκ: Περί Νεολογείν” – Φιλοσοφικό δοκίμιο του Αντώνη Γαβαλά 	essay
 “7 δοκίμια” – Συλλογή του Δήμου Χλωπτσιούδη 	essay
 “Ο χορός των ποιητών / Τάκης Μιχόπουλος” – Δοκίμιο του Θανάση Πάνου 	essay
 “Το μανιφέστο του … Σχετικού!” – του Σωκράτη Α. Τσελεγκαρίδη 	essay
 “Η κρίση των δικαιωμάτων” – Δοκίμιο του Δημήτρη Χριστόπουλου 	essay
“Δημιουργική γραφή – Οδηγίες πλεύσεως” του Μίμη Σουλιώτη 	essay
 “Η μεσαία τάξη στην αγχόνη της κρίσης” – Πολιτικό δοκίμιο του Δήμου  Χλωπτσιούδη 	essay
 “Οι αρβύλες” – Αναμνήσεις ζωής του Κώστα Πατρίκιου 	essay
 “Παραπλανημένος άνθρωπος” – Δοκίμιο του Παντελή Γαβρίλη-Αιγινήτη 	essay
 “Δια-κριτικές ματιές στη λογοτεχνική έκφραση” – Συλλογικό έργο 	essay
“Το κόψε-κόψε ή Όταν οι γκοτζίλες εξανθρωπίζονται” – Δοκίμιο του  Θανάση Τριαρίδη 	essay
 “Η πολιτική βία είναι πάντοτε φασιστική” – Συλλογική έκδοση 	essay
 «Στέλλα Origami» – Νουβέλα της Μικέλας Φερούση 	prose
 «Το πάθος του Κριστιάν ή φωνές από τη χαράδρα» –  Μυθιστόρημα του Αύγουστου Κορτώ 	prose
 «Κρυπτόν Άστυ» – Νουβέλα του Στέλιου Παπαγρηγορίου 	prose
«Σε παλιές πατημασιές» – Μυθιστόρημα του Βασίλη Γρηγοριάδη	prose
«Οι ψίθυροι στους τοίχους» – Μυθιστόρημα της Κατίνας Βλάχου 	prose
 «Ο μολυβοποιός» – Νουβέλα της Μικέλας Φερούση 	prose
«Επιχείρηση 79» - Θεόφιλος Κάλος	prose
 «Οι σχοινοβάτες» – Μυθιστόρημα της Αφροδίτης Κουκουτσάκη 	prose
Δεν θα γίνει επανάσταση στο μικρό χωριό απόψε	prose
 «Η Βιβλιοθηκάριος των Χριστουγέννων» – Νουβέλα της Νιόβης Λύρη 	prose
ΠΕΡΙ ΤΟΥ ΚΟΣΜΟΥ - πύρρων ηλειόπουλος	prose
 «In Absentia» – Νουβέλα της Μικέλας Φερούση 	prose
“Ich Bebe” 	prose
 «Σιωπηλή πέτρα» – Μυθιστόρημα της Ευρυδίκης Αμανατίδου 	prose
 «Ζονγκ» – Μυθιστόρημα του Παντελή Γαβρίλη-Αιγινήτη 	prose
 «Το Χρονικό Ενός Τυχαίου Θανάτου» – Μυθιστόρημα του Μιχάλη Κατράκη 	prose
 «Πανσέληνος 2» – Νουβέλα του Γιώργου Γλυκοφρύδη 	prose
 «Ο δυσκοίλιος μπάτλερ» – Νουβέλα του Γιώργου Γλυκοφρύδη 	prose
 «Ακροπατώντας στην άκρη του ονείρου» – Νουβέλα του Γιάννη Πιταροκοίλη 	prose
 «Cafe Βυζάντιο» – Μυθιστόρημα του Κώστα Χατζιδάκη 	prose
 «Η Σύναξις των Οπαδών της Σόδας» – Μυθιστόρημα του Στέλιου Παπαγρηγορίου 	prose
«Οι Μελανές Εκτάσεις» – Μυθιστόρημα του Στέλιου Παπαγρηγορίου	prose
 «Για κοίτα» – Μυθιστόρημα του Σίμου Πανόπουλου 	prose
 «Το Στιλέτο» – Μυθιστόρημα του Λάκη Φουρουκλά 	prose
 «Το χάρτινο σπέρμα» – Μυθιστόρημα της Κώστιας Κοντολέων 	prose
 «Ο Εξωγήινος της Διπλανής Πόρτας» – Μυθιστόρημα του Αύγουστου Κορτώ 	prose
 «Η ιστορία του Νεμάνια» – Νουβέλα του Ελ Ρόι [+3 τραγούδια] 	prose
 «Αφήγηση» – Νουβέλα του Μάνου Κοντολέων 	prose
 «Αούντι Γλεν» – Μυθιστόρημα του Στέλιου Παπαγρηγορίου 	prose
 «Το βιβλίο των βίτσιων» – Μυθιστόρημα του Αύγουστου Κορτώ 	prose
 «Ο άνεμος σφυρίζει στην Κουπέλα» – Μυθιστόρημα του Θανάση Τριαρίδη 	prose
 «Σεμίνα: Ο Γολγοθάς και οι Αναστεναγμοί της Λύτρωσης» –  Μυθιστόρημα της Μαρίας Σεφέρου 	prose
 «Ο δαιμονιστής» – Μυθιστόρημα του Αύγουστου Κορτώ 	prose
 «Η λαιμαργία» – Μυθιστόρημα του Αύγουστου Κορτώ 	prose
 «Αποφάσισα να σκοτώσω τον Ερμόλαο» – Μυθιστόρημα του Μάνου Κοντολέων 	prose
 «Ο Έρωτας στα Χρόνια της Γκαρσονιέρας» – Μυθιστόρημα του Αύγουστου Κορτώ 	prose
 «Το λάθος πάθος» – Νουβέλα του Λάκη Φουρουκλά 	prose
 «Η σιωπή της πόλης» – Νουβέλα του Νίκου Καρακάση 	prose
 «Τα ουγγρικά ψάρια» – Μυθιστόρημα του Γιάννη Πλιώτα 	prose
 «Η μηλιά, μια ιστορία αγάπης» – Νουβέλα του Πάνου Μανάφη 	prose
«Τα χλωρά διαμάντια» – Μυθιστόρημα του Θανάση Τριαρίδη	prose
«Όσα χωράει μια στιγμή» – Μυθιστόρημα του Στέφανου Λίβου 	prose
«1.000.000 στιγμές» – Μυθιστόρημα του Μιχάλη Φουντουκλή 	prose
 «Ακρίδα, η ένωση της ανθρωπότητας σε ένα ζώο» –  Μυθιστόρημα του Νίκου Μπόνου 	prose
 «Γεώργιος Νέγρος, ο τίγρης του Αιγαίου» – Μυθιστόρημα του Τέου Ρόμβου 	prose
 «Ο Φύλακας στον Φάρο» – Μυθιστόρημα της Ευρυδίκης Αμανατίδου 	prose
 «Έκπτωτοι» – Μυθιστόρημα της Βάλιας Καραμάνου 	prose
 «Ο Αλκίνοος ή ο Αννίδης» – Χιουμοριστικό μυθιστόρημα των Βαγγέλη Μαμανέα,  Παναγιώτη Φωτόπουλου 	prose
«Το τέλος» – Νουβέλα του Τάκη Κουφόπουλου	prose
 «Απόλογος» – Νουβέλα του Τάκη Κουφόπουλου 	prose
 «Το μυστικό των εξωγήινων» – Μυθιστόρημα του Μπάμπη Δερμιτζάκη 	prose
 «Οι Άγιοι με τα Πορφυρά Μάτια» – Μυθιστόρημα του Μάριου Μητσόπουλου 	prose
Το άρμα του ήλιου - Συνοδινού Ράνια	prose
«Αλλού στο Λιμιώνα του Μπαρμπαμήτσου» – Νουβέλα του Δημήτρη Μπαρσάκη 	prose
«Μια ιστορία αγάπης» – 15+1 bloggers	prose
 «ΝΤΑΡΚ» – Νουβέλα του Δημήτρη Κωνσταντίνου 	prose
 «Κρούγκερ» – Νουβέλα του Δημήτρη Κωνσταντίνου 	prose
 «Unabomber» – Νουβέλα του Δημήτρη Κωνσταντίνου 	prose
 «Δυτικά της Ανατολής» – Μυθιστόρημα του Πάνου Κολιόπουλου 	prose
«Οι Θρύλοι δεν ξαποσταίνουν ποτέ» – Μυθιστόρημα του Πάνου Κολιόπουλου 	prose
 «Ο Φωτοτυπίας» – Μυθιστόρημα του Πάνου Κολιόπουλου 	prose
 «Ο Λέων των Ερτζιανών» – Μυθιστόρημα του Πάνου Κολιόπουλου 	prose
«Μωρή Σούλα, τι γινήκανε οι άντρηδοι, μωρή;» –  Μυθιστόρημα του Πάνου Κολιόπουλου 	prose
 «Αντ’ Αυτών» – Μυθιστόρημα του Πάνου Κολιόπουλου 	prose
 «I, SPIROS – Γκομενογεωγραφία (Μέρος Β’)» –  Μυθιστόρημα του Πάνου Κολιόπουλου 	prose
«I, SPIROS – Γκομενογεωγραφία (Μέρος Α’)» –  Μυθιστόρημα του Πάνου Κολιόπουλου	prose
 «SPIROS για πάντα» – Μυθιστόρημα του Πάνου Κολιόπουλου 	prose
«Θρύλοι της Γειτονιάς» – Μυθιστόρημα του Πάνου Κολιόπουλου	prose
 «Αχ, Γυναίκες!» – Μυθιστόρημα του Πάνου Κολιόπουλου 	prose
 «Τα Αλανάκια» – Μυθιστόρημα του Πάνου Κολιόπουλου 	prose
 «Το Τραγούδι της Ψυχής» – Μυθιστόρημα του Κώστα Βουλαζέρη 	prose
 «Οι Φύλακες των Πάγων» – Μυθιστόρημα του Κώστα Βουλαζέρη 	prose
 «Ο Θάνατος του Ξενιστή» – Μυθιστόρημα του Κώστα Βουλαζέρη 	prose
 «Η Χαωδία» – Νουβέλα του Κώστα Βουλαζέρη 	prose
 «Γάμος του Ήλιου και του Ανέμου» – Νουβέλα του Κώστα Βουλαζέρη 	prose
 «Θάνατος στο πάρκο» – Μυθιστόρημα της Λένας Μαυρουδή Μούλιου 	prose
«Χωρίς σημεία στίξεως σιωπή» – Μυθιστόρημα του Λευτέρη Κρητικού 	prose
«Μια σειρά από τρομαχτικά γεγονότα» –  Μυθιστόρημα του Μίνωα Αθανάσιου Καρυωτάκη 	prose
 «Το νήμα της μέλισσας» – Μυθιστόρημα του Λευτέρη Κρητικού 	prose
 «Θάνατος, Καλοκαίρι, Φθινόπωρο, Χειμώνας» –  Μυθιστόρημα της Ευτυχίας Κανάρη 	prose
 «Johnnie Society» – Μυθιστόρημα του Γιάννη Φαρσάρη 	prose
«ΕξοΡγισμός» – Μυθιστόρημα του Δημήτρη Νότα	prose
 «Δαντέλα από τον Λίγηρα» – Νουβέλα του Βασίλη Πουλημενάκου 	prose
«Σουμπέρτα» – Νουβέλα της Γιώτας Τσιλίκη	prose
 «Οι πέντε σφραγίδες και ο χαμένος πρίγκιπας» –  Μυθιστόρημα της Στέλλας Χαβενετίδου 	prose
«Εξ αίματος» – Νουβέλα της Λιλής Γάτη	prose
 «Ο Δράκος και οι σκορδοφάγοι ιππότες» –  Μυθιστόρημα της Ευρυδίκης Αμανατίδου 	prose
 «Κωδικό όνομα: Αφύπνιση» – Μυθιστόρημα του Μίνωα – Αθανάσιου Καρυωτάκη 	prose
«Λίβηθρα» – Μυθιστόρημα της Βάλιας Καραμάνου	prose
 «Εγώ και η αδερφή της» – Μυθιστόρημα του Παναγιώτη Παπανικολάου 	prose
 «ΟΛΙΣ.ΘΗΣΗ» – Μυθιστόρημα του Παύλου Κουτρουμπά 	prose
 «Όποια κι αν ήταν η μητέρα μου» – Μυθιστόρημα της Ευτυχίας Κανάρη 	prose
 «Μαύρο Κόκκινο» – Μυθιστόρημα του Άγγελου Χαριάτη 	prose
 «Σαλιώνοντας Γραμματόσημα» – Μυθιστόρημα του Δημήτρη Νότα 	prose
 «Η ακριβή ανάσα του νερού» – Μυθιστόρημα της Ευρυδίκης Αμανατίδου 	prose
 «Αραμπέλα / Τα όρια της πίστης» – Μυθιστόρημα της Ευρυδίκης Αμανατίδου 	prose
«Αντιγόνη» – Μυθιστόρημα του Σταύρου Παπανικολάου	prose
 «Πογκρόμ» – Μυθιστόρημα της Ελένης Σεμερτζίδου 	prose
 «Το φάντασμα του πέτρινου φάρου» – Μυθιστόρημα της Ελένης Σεμερτζίδου 	prose
 «Ψυχική Ανατολή» – Νουβέλα του Βασίλη Δημητριάδη 	prose
 «Δυο φωνές και μια σιωπή» – Μυθιστόρημα του Λάκη Φουρουκλά 	prose
 «Τη λένε Χαρά» – Νουβέλα του Λάκη Φουρουκλά 	prose
 «Κείμενο πάθος» – Μυθιστόρημα του Τέου Ρόμβου 	prose
 «Πλάνος δρόμος» – Μυθιστόρημα του Τέου Ρόμβου 	prose
 «Λευκό χαρτί» – Μυθιστόρημα του Αντώνη Γαβαλά 	prose
 «Οι κόρες της Αφροδίτης» – Μυθιστόρημα του Μιχάλη Πιτένη 	prose
 «Ο αέρας» – Νουβέλα του Στέφανου Παπαχρήστου 	prose
 «Βασιλιάς της Περγάμου» – Ιστορικό μυθιστόρημα του Ευστράτιου 	prose
 «Το μάτι του Ελέφαντα» – Φιλοσοφικό μυθιστόρημα του Χριστόφορου Ακριτίδη 	prose
 «Give Or Die» – Μυθιστόρημα του Νίκου Τσάμη 	prose
 «Ο Συντονιστής» – Μυθιστόρημα του Νίκου Τσάμη 	prose
 «Ο Μπάντυ» – Μυθιστόρημα του Νίκου Τσάμη 	prose
 «Ο αυτουργός» – Μυθιστόρημα του Νίκου Φάκου 	prose
 «Πρωινό Ιντερσίτυ» – Μυθιστόρημα της Νιόβης Λύρη 	prose
 «Οι εθελοντές» – Μυθιστόρημα της Νιόβης Λύρη 	prose
 «Το Ασημένιο Ρόδο» – Μυθιστόρημα της Νιόβης Λύρη 	prose
 «Μίλα μου για ξόρκια» – Μυθιστόρημα του Νικόλα Αφρόκαλου 	prose
 «Για ένα μικρό κομμάτι χαρτί» – Μυθιστόρημα του Χριστόφορου  Παπαχαραλάμπους 	prose
 «Άνω Κάτω Τελεία» – Νουβέλα της Θεοδοσίας (Theda) Καϊδόγλου 	prose
 «Ένα κομματάκι κόσμου» – Νουβέλα της Μάρης Τσαμακίδου Παπαποστόλου 	prose
 «Το νησί της Καλυψώς» – Νουβέλα της Γεωργίας Ανδρουλιδάκη & του  Γρηγόρη Παπαδογιάννη 	prose
 «Δικλείδα ασφαλείας» – Νουβέλα της Δάφνης Χασούρου & του Νικόλα Στασινού 	prose
 «Το γράμμα» – Νουβέλα της Ρένας Τσαβαρή & του Βασίλη Χατζάκη 	prose
 «Φρίντα & Βικτώρια» (αδελφότητα γυναικών) – Νουβέλα των  Φώφης Walter-Κυρλίδου και Βάσως Αποστολοπούλου 	prose
 «Ο Λιάκος» – Μυθιστόρημα του Βαγγέλη Τσερεμέγκλη 	prose
 «Φύση των Φαινομένων» – Ποιητική συλλογή της Ελένη Γεωργίου 	poem
 «Μικρή ανθολογία σύγχρονης ανέκδοτης ελληνικής σατιρικής ποίησης» –  Μέρος Τέταρτον 	poem
 «Βίβιαν μη» – Ποιητική συλλογή του Maurice Labrador 	poem
 “Το εξώφυλλο δέρμα του κόσμου” – Ποιητική συλλογή του Πάνου Οικονόμου 	poem
 “Η πλάνη” – Ποιητική συλλογή του Βασίλη Στόικου 	poem
 “Συνουσίες και άλλα εγκλήματα” – Ποιητική συλλογή του Βασίλη Στόικου 	poem
 «Τα φώτα στα νερά» – Ποιητική συλλογή του Αντώνη Περδικούλη 	poem
 «Θλίψης Τρόπαια» – Ποιητική συλλογή του Αντώνη Περδικούλη 	poem
 “Μικρές εξορίες” – Ποιητική συλλογή της Ρούλας Τριανταφύλλου 	poem
"GNOSSIENNES" - Γιώργος Μπλάνας	poem
 “Τα Ανένταχτα ΙΙ” – Ποιητικά κείμενα του Γιώργου Σ. Κόκκινου 	poem
 “Τα Ανένταχτα” – Ποιητικά κείμενα του Γιώργου Σ. Κόκκινου 	poem
 “Στίχοι για υγρούς θανάτους” – Ποιητική συλλογή του Ντέμη Κωνσταντινίδη 	poem
 “Βαδίζοντας στα κύματα” – Ποιητική συλλογή του Τίμου Ζούμπου 	poem
 “Εκλεκτή της καρδιάς μου” – Ποιητική συλλογή του Πάνου Μιχελή 	poem
 “Πνοή μες στην Ψυχή” – Ποιητική συλλογή της Άννα-Μαρία Θεοχαροπούλου 	poem
 “Με γράφουν στην ταυτότητα Σταύρο Καραμανιώλα” – Ποιητική συλλογή 	poem
 “Mine” – Ποιητική συλλογή του Paul Cendrier 	poem
 “Ο Αναβάτης” – Ποιητική συλλογή του Ευθύμιου-Ραφαήλ Αγγελή 	poem
 “Φιλοσοποιήματα (2)” – Συλλογή του Σαράντη Σαραντόπουλου 	poem
 “Φιλοσοποιήματα (1)” – Συλλογή του Σαράντη Σαραντόπουλου 	poem
 “Ο ήλιος της σκιάς μου” – Ποιητική συλλογή του Βασίλειου Κάππα 	poem
 “Μέλη με μέλι” – Ποιητική συλλογή του Βασίλειου Κάππα 	poem
 “Ράβδοι πλαστελίνης” – Ποιητική συλλογή της Ιωάννας Πιτσιλλή 	poem
 “Μια μπουνιά κι ένα φιλί” – Ποιητική συλλογή του Βασίλειου Κάππα 	poem
 “Ανοίγοντας παλιά συρτάρια” – Ποιητική συλλογή του Βασίλειου Κάππα 	poem
 “Καρπούζια στο κατώι” – Συλλογή του Γ. Κατσάκου 	poem
 “Μια παιδική εποχή – Αναπόληση του αγνού” – Ποιητική  συλλογή του Βασίλειου Κάππα 	poem
 “16 αριθμοί και 24 γράμματα” – Ποιητική συλλογή του Δημήτριου Γκόγκα 	poem
 “Σε μία Olympia Traveller ’79” – Ποιητικό μανιφέστο του Μιχάλη Κατράκη 	poem
 “Ελεύθερες εξορίες” – Ποιητική συλλογή του Ηλία Τσέχου 	poem
 “Ποιήματα 1942-1946” – Συλλογή του Τάκη Κουφόπουλου 	poem
 “Διχθά” – Ποιητική συλλογή του Τάκη Κουφόπουλου 	poem
 “Ξεψαχνίζοντας το παρελθόν” – Ποιητική συλλογή του Βασίλειου Κάππα 	poem
 “Σπασμένα φεγγάρια” – Ποιητική συλλογή του Νικόλα Χουέρβου 	poem
 “Φαινομενολογία Του Γυμνού Πνεύματος” – Ποιητική συλλογή  του Αντώνη Αντωνάκου 	poem
 “Ένα φεγγάρι κοιτάζει απ’ το παράθυρο” – Ποιητική συλλογή του Σάκη Αθανασιάδη 	poem
 “Ζωολόγιον θηλυκών και άλλων πλασμάτων” – Ποιητική συλλογή του  Αντώνη Αντωνάκου 	poem
 “Στιγμές από το ρεπερτόριο του θανάτου” – Ποιητική συλλογή του Θοδωρή Βοριά 	poem
 “Ονειρικές Ακολουθίες” – Ποιητική συλλογή της Παγώνας Παρασύρη 	poem
 “Οι Κωπηλάτες” – Ποιητική συλλογή του Χρήστου Ε. Δημάκη 	poem
 “Χειμερινή ισημερία” – Ποιητική συλλογή του Νίκου Σουβατζή 	poem
 “Αυτεπίστροφο” – Ποιητική συλλογή του Σπύρου Σ. Βουτσινά 	poem
 “Το τρίτο ρεύμα – Ποιητική” – Αρχείο οπτικής Ποίησης Ελλήνων &  Ξένων Λογοτεχνών 	poem
 “Σχέδιο Γ” – Ποιητικές δοκιμές του Ιωάννη Αναγνώστη 	poem
 «Λύρα» & «Τα Λυρικά» – Ωδές του Ανδρέα Κάλβου 	poem
 “Η Φοινικιά” – Ποίημα του Κωστή Παλαμά 	poem
 “Αλγοσαρωνικός” – Ποιητική συλλογή του Βασίλη Ντόκου 	poem
 “Τα άλεκτα του Αλέξανδρου” – Ποιητική συλλογή του Βασίλη Ντόκου 	poem
 “Κυλιόμενο φως” – Ποιητική συλλογή του Βασίλη Ντόκου 	poem
 “Οι καλύτερες προθέσεις” – Ποιητική συλλογή του Βασίλη Ντόκου 	poem
 “Ράμπο, όπως Ρεμπώ” – Ποιητική συλλογή του Βασίλη Ντόκου 	poem
 “Μεταποίηση” – Ποιητική συλλογή του Βασίλη Ντόκου 	poem
 “Ο Άγνωστος Ταξιδιώτης” – Ποιητική συλλογή του Αντώνιου Σάραγκα 	poem
 “Ασκήσεις συναισθήματος” – Ποιητική συλλογή του Γιάννη Τόλια 	poem
 “Ο κοινός μας γνωστός” – Ποιητική συλλογή του Νίκου Χαλκίδη 	poem
 “Τραγούδια του χαμένου δυόσμου” – Ποιητική συλλογή της Έλλης Παιονίδου 	poem
 “Κλεψύδρα” – Ποιητική συλλογή της Έλλης Παιονίδου 	poem
 “Ονειρεμένος Πόλεμος” – Ποιητική συλλογή του Χρήστου Διαμαντή 	poem
 “Wstawac, όταν η Ιστορία απελευθερώνει” – Ποιητική συλλογή  του Θανάση Τριαρίδη 	poem
 “Aντιχαιρετισμός” – Ποιητική συλλογή του Κωνσταντίνου Ποζουκίδη 	poem
 “Λυδία” – Ποιητική συλλογή του Θανάση Φωτιάδη 	poem
 “Ο κύκλος της καταγγελίας” – Ποιητική συλλογή της Έλλης Παιονίδου 	poem
 “Κι εσύ το είδες” – Ένα ποίημα, σαράντα ποιητές 	poem
 “Codepoem: Επιδρομή Στην Πόλη” – Ποιητική συλλογή 	poem
 “Ολονυκτία της Αφροδίτης” – Ποίηση σε απόδοση Βασίλη Λαλιώτη 	poem
 “Μικρά όνειρα και μια αναφορά στην Αρσινόη” – Ποιητική συλλογή του  Κώστα Κωνσταντινίδη 	poem
 “Στην Χώρα Των Τραυμάτων” – Σουρεαλιστική συλλογή ποιημάτων  της Μαρίας Χαλλούμι 	poem
 “Διάθεση Ημέρας” – Ποιητική συλλογή του Βάσου Γεώργα 	poem
 “Εκύκλωσαν, αι του βιου με ζάλαι” – Ποιητική συλλογή του Γιάννη Τσίγκρα 	poem
 “Του Αποπλανητή” – Ποιητική συλλογή Ανωνύμου 	poem
 “Κατηγορώ” – Ποιητική συλλογή του Γιώργου Σ. Κόκκινου 	poem
 “Φυγείν εστί” – Ποιητική συλλογή του Γιώργου Σ. Κόκκινου 	poem
 “Παντός καιρού” – Ποιητική συλλογή του Δημήτριου Γκόγκα 	poem
"Ποιήματα" - Ασημίνα Ξηρογιάννη	poem
 “Πάνω Δεξιά” – Ποιητική συλλογή του Βασίλη Λαλιώτη 	poem
 “Φρουρός της λύπης μου” – Ποιητική συλλογή της Κατερίνας Αγυιώτη 	poem
 “Τα φιλιά” – Ποιητική συλλογή του Βασίλη Λαλιώτη 	poem
 “Το τελευταίο σκοτάδι” – Ποιητική συλλογή του Νικόλα Χουέρβου 	poem
 “Ο δαίμονας που με κατοικεί” – Ποιητική συλλογή του Νικόλα Χουέρβου 	poem
 “Στου έρωτα κοιτίδα” – Ποιητική συλλογή του Γεράσιμου Μοσχόπουλου 	poem
 “Το ημερολόγιο της μπλε κουβέρτας” – Ποιητική συλλογή της Αθανασίας  Δρακοπούλου 	poem
 “Ποιος είπε πως οι λέξεις δεν ονειροβατούν;” – Ποιητική συλλογή της  Κωνσταντίνας Γερονικάκη 	poem
"Κηφισιά" - Σωτήρης Παστάκας	poem
 “Δώδεκα άτακτα κιβώτια” – Ποιητική συλλογή του Βασίλη Κάρδαρη 	poem
 “Διασπορά” – Ποιητική συλλογή του Γιώργου Καρτάκη 	poem
 “Παραλειπόμενα” – Ποιητική συλλογή του Νίκου Βαραλή 	poem
 “Κρίσιμες σιωπές” – Ποιητική συλλογή του Βασίλη Σιουζουλή 	poem
 “Σε διαδικασία εξομάλυνσης” – Ποιητική συλλογή του Λεωνίδα Χ. Μπόμπα 	poem
 “Φιλί στον κοχλία” – Συλλογική ποίηση 	poem
 “Έρωτας μικρού μήκους” – Συλλογή του Γιώργου Χαντζή 	poem
 «Τερατούργημα» – Ποιητική συλλογή του Γιώργου Μπλάνα 	poem
"Επεισόδιο" - Ένα πολιτικό ποίημα του Γιώργου Μπλάνα	poem
"Η απάντησή του" - Γιώργος Μπλάνας	poem
 «Η Ζωή Κολυμπά Σαν Φάλαινα Ανύποπτη Πριν Τη Σφαγή» –  Ποιητική συλλογή του Γιώργου Μπλάνα 	poem
 «Η Αναπόφευκτη Ανθηρότητά σου» – Ποιητική συλλογή του Γιώργου Μπλάνα 	poem
"Νύχτα" - Γιώργος Μπλάνας	poem
 “Ευλύγιστες Μελαγχολίες” – Ποιητική συλλογή του Ντέμη Κωνσταντινίδη 	poem
 “Οιμωγές” – Ποιητική συλλογή του Βάιου Νικιώτη 	poem
 “Τιττυβισμοί” – Ποιητική συλλογή του Βασίλη Λαλιώτη 	poem
 “Πέρασμα στον Υδάσπη” – Ποιητική συλλογή του Κώστα Πουλιανίτη 	poem
 “Μηνολόγιον” – Ποιητική συλλογή του Κώστα Πουλιανίτη 	poem
 “Καθ’ οδόν ορά” – Ποιητική συλλογή του Κώστα Πουλιανίτη 	poem
 “Φυτολόγιο” – Ποιητική συλλογή του Paul Cendrier 	poem
 “Occasional Butterfly” – Ποιητική συλλογή του Paul Cendrier 	poem
 “Αλάνυα” – Ποιητική συλλογή του Paul Cendrier 	poem
 “Να έρχεσαι” – Ποιητική συλλογή της Στέλλας Βλαχογιάννη 	poem
 “Λόγοι Χ Αμερικής” – Ποιητική συλλογή του Γιώργου Αναγνώστου 	poem
“Ο εαυτός ήχος” – Ποιητική συλλογή του Γιώργου Γέργου	poem
 “Εκφράσεις” – Ποιητική συλλογή του Βασίλη Λαλιώτη 	poem
 “Εφτά Σ’ Αγαπώ με Τίτλους του Τσετ Μπέικερ” – Ποιήματα του Βασίλη Λαλιώτη 	poem
 “Κούκου Νιάου” – Ποιητική συλλογή του Θεόδωρου Μπασιάκου 	poem
"Καπνός και έρωτας" - Σταφανί Κειρούζ	poem
 “Ωδή των Πετεινών” – Ποιητική συλλογή του Βασίλη Δασκαλάκη 	poem
 “Ζωή στη δίνη” – Συλλογή ποιημάτων του Χρήστου Γεωργιάδη 	poem
 “Τελεστήρια” – Ποιητική συλλογή του Βασίλη Λαλιώτη 	poem
 “Ποιητικώς Υπάρχειν” – Ποιητική συλλογή του Πάνου Α. Ζέρβα 	poem
 “Εκκρεμότητα” – Ποιητική συλλογή από την Μαρία (Μόιρα) Μπιζάνου 	poem
 “Αγέρες” – Ποιητική συλλογή του Πασχάλη Παπαβασιλείου 	poem
 “Του ανέμου δίλημμα” – Ποιητική συλλογή του Πασχάλη Παπαβασιλείου 	poem
 “Τέλος εποχής” – Ποιητική συλλογή του Πασχάλη Παπαβασιλείου 	poem
 “Πόθοι του χθες” – Ποιητική συλλογή του Πασχάλη Παπαβασιλείου 	poem
 “Ποιήματα 2017-2018” – Ποιητική συλλογή του Πασχάλη Παπαβασιλείου 	poem
 “Ελληνική ποίηση – Έλληνες ποιητές” – Συλλογή του Οδυσσέα Γκιλή 	poem
 “Εναρμόνια” – Ποιητική συλλογή του Βάιου Νικιώτη 	poem
 “Εξομολόγηση” – Ποιητική συλλογή της Μαρίας Φιλίπποβα-Χαντζή 	poem
 “Νοσταλγία” – Ποιητική συλλογή του Νίκου Βαρδάκα 	poem
 «Της καύλας» – Ποιητική συλλογή του Δημήτρη Φύσσα 	poem
 “Θαλάσσια μπάνια” – Ποιήματα του Βασίλη Λαλιώτη 	poem
"Επιλογή" - Γιώργος Στασινόπουλος	poem
 “Άχρονη Μετάβαση” – Ποιητική συλλογή του Γρηγόρη Σακαλή 	poem
 “Πρώτα Κατάλοιπα” – Ποίηση του Φώτη Παπαδόπουλου 	poem
"Ποιήματα" - Γιώργος Γκούμας	poem
"Ποιήματα" - Κώστας Σοφιανός	poem
 “Μελιδόνι” – Ποιητική συλλογή της Βασιλικής Λόη 	poem
"Χώρις" - Μιράντα Παπαδοπούλου	poem
 “Κατά ασπαράκτων” – Ποιητική συλλογή του Χρίστου Παλαιοπάνου 	poem
 “Δεσμώτες” – Ποιητική συλλογή του Κωνσταντίνου Κ. Χατούπη 	poem
 “Εφημερόπτερα” – Ποιητική συλλογή του Ντέμη Κωνσταντινίδη 	poem
 “Ανθρωποθυσία” – Ποιητική συλλογή του Γιάννη Βούλτου 	poem
 “Η ασφαλής ομήγυρη” – Ποιητική συλλογή του Ντέμη Κωνσταντινίδη 	poem
 “Περίπολος για τους εναπομείναντες” – Ποιήματα του Ντέμη Κωνσταντινίδη 	poem
 “Αχίλλειος Γραφή” – Ποιητική συλλογή της Μαρίας Χαραλαμπίδη 	poem
 “Γενναιολογικό Δέντρο” – Ποιητική συλλογή της Μαρίας Χαραλαμπίδη 	poem
“Εισπνοή έρωτα, εκπνοή θανάτου” – Ποιητική συλλογή του Κωνσταντίνου Σιάκα	poem
 “Σ’ αυτό το σύμπαν που τολμά” – Ποιητική συλλογή της Ελένης Σεμερτζίδου 	poem
 “Ταξίδι στη Ζωή” – Ποιητική συλλογή της Λένας Σεπτέμβρη 	poem
 “Ιδέες & ποίηση μιας απροσάρμοστης λογικής” – Ποιητική  συλλογή του Χρήστου Γεωργακόπουλου 	poem
 “Ζω ονειρευόμενος, Αγάπη” – Ποιητική συλλογή του Θάνου Πάσχου 	poem
 “Με μιας Μιλέδης τη ματιά” – Ποιητική συλλογή της Ελένης Σεμερτζίδου 	poem
 “Της μοναξιάς η ρίμα…” – Ποιητική συλλογή της Ελένης Σεμερτζίδου 	poem
 “Χαμένες ψηφίδες” – Ποιητική συλλογή του Θοδωρή Βοριά 	poem
 “Σε καιρούς χαλεπούς” – Ποιητική συλλογή της Μαρίας Μουρζά 	poem
 “Το γυάλινο δωμάτιο” – Ποιήματα & πεζοτράγουδα της Καίτης Λιανού – Ιωαννίδου 	poem
"Ποιήματα" - Συλλογή Α' του Νικόλαου Νεραντζή	poem
"Ποιήματα" - Συλλογή Β' του Νικόλαου Νεραντζή	poem
"Ποιήματα" - Συλλογή Γ' του Νικόλαου Νεραντζή	poem
 “Όνειρα σε κρεματόρια” – Ποιητική συλλογή του Σταύρου Δανιηλίδη 	poem
 “Κράτα την σιωπή” – Ποιητική συλλογή της Λίτσας Κυπραίου 	poem
 “Πάθη, λάθη κ’ έρωτες” – Ποιητική συλλογή της Θεοδώρας Φελέρη 	poem
 “Αικατερίνης Θεομηνίες” – Ποιητική συλλογή του Αντώνη Αντωνάκου 	poem
 “Φεγγαράκια” – Ποιητική συλλογή του Αντώνη Αντωνάκου 	poem
 “Στη γειτονιά των αγγέλων” – Ποιητική συλλογή του Γεωργίου Γαλάτση 	poem
 “Γιουσουρούμ” – Ποιητική συλλογή του Νίκου Λέκκα 	poem
 “Ο οβολός του λεμβούχου” – Ποιητική συλλογή του Βύρωνα Ρωμανού 	poem
 “Από τις Ερινύες στις Κήρες” – Ποιητική συλλογή του Γιώργου Καββαδία 	poem
 “Περπάτησα στο δρόμο που σκέπασε η στάχτη” – Ποιητική συλλογή  του Γιώργου Καββαδία 	poem
 “Η βουβή παρέμβαση ενός σήπτοντα νου” – Ποιητική συλλογή  του Φιλάρετου Στεφανάκη 	poem
 “Ο Samurai και ο Σπαρτιάτης” – Συλλογή χαϊκού του Θανάση Πάνου 	poem
 “Στου αιώνα μου το θαύμα” – Ποιητική συλλογή του Αλέξανδρου Βλαχιώτη 	poem
 “Η φαντασία ελεύθερη πετά” – Ποιητική συλλογή του Αλέξανδρου Βλαχιώτη 	poem
 “Τώρα περίμενε / Adesso Aspetta” – Ποιητική συλλογή από τον Χριστόφορο  Παπαχαραλάμπους & τον Gaetano Trimarchi 	poem
"Ψηφίδες" - Βάσω Αποστολοπούλου - Αναστασίου	poem
 “Η οργή της πεταλούδας” – Κοινωνική ποίηση του Δήμου Χλωπτσιούδη 	poem
 “Τα κενά… κι άλλα σκόρπια συναισθήματα” – Ποιητική συλλογή του Χάρη Γαντζούδη 	poem
 «Η λιτάνευση του ιχθύος» – Διηγήματα της Κατίνας Βλάχου 	prose
 «Μικρές αλήθειες» – Διηγήματα της Ρούλας Κοντέα 	prose
 «Σαν παραμύθι» – Διήγημα της Βενετίας Σπ. Βαλμά 	prose
 «Ταξίδια από χαρτί» – 16 μικρές ιστορίες 	prose
 «Αυτή είναι η δική μου ιστορία» – 26 ιστορίες ζωοφιλικού περιεχομένου 	prose
 «6 Φωνές, 6 Γυναίκες» – Συλλογή διηγημάτων 	prose
"Το σχολείο" - Ε' Διαγωνισμός του Στέλιου Ξεφλούδα	prose
"Λόγος του 18" - το βιβλίο net	prose
 «Ψήγματα» – Συλλογή διηγημάτων του Τάκη Κουφόπουλου 	prose
 «Εκδοχές» – Συλλογή διηγημάτων του Τάκη Κουφόπουλου 	prose
 «Σχάσεις» – Συλλογή διηγημάτων του Τάκη Κουφόπουλου 	prose
 «Η οδός» – Συλλογή διηγημάτων του Τάκη Κουφόπουλου 	prose
 «Μικρές σύγχρονες ιστορίες» – Συλλογή διηγημάτων του Τάκη Κουφόπουλου 	prose
 «European stories» – Συλλογή διηγημάτων από τους  νικητές του Βραβείου Λογοτεχνίας της Ευρωπαϊκής Ένωσης 	prose
 «Χίλια μιλιγκράμ απουσίας» – Συλλογή διηγημάτων του Μιχάλη Κατράκη 	prose
 «Από το σκοτάδι στο φως» – Διηγήματα των Αλέξανδρου Λιάμπα &  Μαρίας Μανώλη 	prose
 «Orenta 1863» – Διήγημα του Μιχάλη Κατράκη 	prose
"Χαρά.Ζει" - Γιάννης Τζανης	prose
"Ο ...Κατσαντώνης" - Διήγημα του Δημήτρη Τζουβάλη	prose
« Καφενείον "Το ωραίον Ξηρόμερον"» - Δημήτρης Τζουβάλης	prose
"Ονειροδρόμος - Εννιά όνειρα κι ένας εφιάλτης" - Δημήτρης Τζουβάλης	prose
"Αερήδες" - Διήγημα του Δημήτρη Τζουβάλη	prose
"Μυρωδιά από μοσχοσάπουνο" - Διήγημα του Δημήτρη Τζουβάλη	prose
"Αλλοτροπία - η πόλη με τ' ανθρωπάκια που κοιμούνται" - Μακρύ διήγημα του  Δημήτρη Τζουβάλη	prose
"Wrighte or Die" - Νίκος Γκίκας	prose
"Orenta 1763" - Μιχάλης Κατράκης	prose
 «Ο ανάποδος καθρέφτης» – Συλλογή διηγημάτων της Χριστίνας Σουλελέ 	prose
 «Η Προφητεία» – Διήγημα του Πύρρωνα Ηλειόπουλου 	prose
 «The Belvedere» – Διήγημα του Γιώργου Γλυκοφρύδη 	prose
"Μυθο-λογίες" - Απόστολος Λαγαριάς	prose
 «Εδώ Πολυτεχνείο» – Συλλογή διηγημάτων του Οδυσσέα Δαγκλή 	prose
 «Ορέ Ποίο; Ζακυνθινά Στιγμιότυπα» – Διηγήματα του Γιώργου Πυλαρινού 	prose
 «Της Τέχνης τα Φαρμάκια» – Διήγημα του Γιάννη Βλαχογιάννη 	prose
 «Ανθολόγιο των κακών Αμερικάνων» – Συλλογή διηγημάτων 	prose
 «Έχει φύλο η καρδιά;» – Πανελλήνιος Μαθητικός Διαγωνισμός  Δημιουργικής γραφής 	prose
"Εύα" - Βασίλειος Φ. Δρόλιας	prose
 «Ονειρεύτηκα τα Λευκά Χριστούγεννα» – Διήγημα του Θανάση Τριαρίδη 	prose
 «Κλεφτές Ματιές» – Συλλογή διηγημάτων του Στέφανου Λίβου 	prose
 «7 λέξεις» – 1ος διαγωνισμός διηγήματος “ΛόγωΤέχνης” 	prose
 «Ιστορίες διαδικτύου» – 2ος διαγωνισμός διηγήματος “ΛόγωΤέχνης” 	prose
 «Η μετάσταση» – Διήγημα του Κωνσταντίνου Ποζουκίδη 	prose
 «Το αγόρι πίσω απ’ το τζάμι» – Διήγημα του Θανάση Τριαρίδη 	prose
 «Ιστορίες της Άγριας Δύσης» – Συλλογή διηγημάτων του Μίνωα-Αθανάσιου  Καρυωτάκη 	prose
 «Οι Ναΐτες πετάχτηκαν δίπλα» – Διηγήματα του Γιώργου Τσαντίκου 	prose
 «Τρία φεγγάρια στην πλατεία» – Διηγήματα του Τέου Ρόμβου 	prose
 «Μαύρο χιόνι» – Διήγημα του Νώντα Τσίγκα 	prose
 «Μια παράξ3νη Κυρι4κή» – Διηγήματα – Συλλογικό έργο 	prose
 «Είμαστε επτά» – Διήγημα του Βασίλειου Δρόλια 	prose
 «Απογιούρα» – Συλλογή διηγημάτων του Δημήτρη Δεγαμινιώτη 	prose
 «Μορφές της κρίσης» – Διηγήματα – Συλλογικό έργο 	prose
 «Ουτοπίες > Ανατολή» – Συλλογή 13 διηγημάτων 	prose
 «Λοιπόν, κυρ-Δασινά» – Μικρές ιστορίες της Ασημίνα Λαμπράκου 	prose
 «Δυο Πιάνα» – Συλλογή ιστοριών της Τζίνας Μουκριώτη και του Βασίλη Λαλιώτη 	prose
 «Σε γκρίζο φόντο» – Διήγημα της Θεοδώρας Φελέρη 	prose
 «Υδροχόος με Σκορπιό» – Διηγήματα της Λένας Μαυρουδή Μούλιου 	prose
 «Η πόρτα στα δεξιά» – Διηγήματα της Λένας Μαυρουδή Μούλιου 	prose
 «Ιστορίες της κρίσης» – Διηγήματα του Χρήστου Γκίμτσα 	prose
"Ξανά" - Φαίη Φραγκισκάτου	prose
 «Εβδόμη εσπερινή» – Μικρές ιστορίες του Γιάννη Φαρσάρη 	prose
 «Έγκλημα στο χωριό» – Τα 12 βραβευμένα διηγήματα του Β ‘  Διαγωνισμού “Στέλιος Ξεφλούδας” 	prose
 «Καπνός» – Τα 15 βραβευμένα διηγήματα του Γ’ Διαγωνισμού “Στέλιος Ξεφλούδας” 	prose
 «Κάποτε στο Μεσολόγγι» – Συλλογή διηγημάτων του Οδυσσέα Δαγκλή 	prose
 «Κιμονό» – Διηγήματα του Γιάννη Μισουρίδη 	prose
"Μονόλογοι" - Συλλογικός Τόμος	prose
 «Όλα θα πάνε Καλά» – Διηγήματα του Μανώλη Μαυραντωνάκη 	prose
 «Το τραγούδι του μήνα» – Συλλογή ιστοριών της Γεωργίας Παπαδοπούλου 	prose
 «Σκόρπια και Ξεχασμένα» – Διηγήματα του Πάνου Κολιόπουλου 	prose
 «Τιμόκλη, φέτος να σμίγουμε ξανά» – Συλλογή διηγημάτων του Πάνου Α. Ζέρβα 	prose
 «Μετρώντας τα τραγούδια, αμέτρητα» – Ιστορίες του Πάνου Α. Ζέρβα 	prose
 «Ένας αυτοκρατορικός θάνατος» – Οκτώ ιστορίες της υπαίθρου του Πάνου Α. Ζέρβα 	prose
"Ο καρπός της γνώσεως του καλού" - Δημήτρης Τζουβάλης	prose
"Το βρακί της Νίκας" - δημήτρης Τζουβάλης	prose
"Νυχτανθοί και νεράιδες" - Δημήτρης Τζουβάλης	prose
"Ελεύθεροι Πολίτες" - Δημήτρης Τζουβάλης	prose
"Διοικητής Φρουράς Μαραθώνος" - Δημήτρης Τζουβάλης	prose
"Δια τας ανάγκας του Ιδρύματος" - Δημήτρης Τζουβάλης	prose
 «Στο Φυλάκιο της Ερημιάς» – Διήγημα του Κώστα Βουλαζέρη 	prose
 «Οι Άνεμοι, το Μήνυμα, και ο Κώδικας» – Διήγημα του Κώστα Βουλαζέρη 	prose
 «Ο Λαγός και το Άνοιγμα του Χρόνου» – Διήγημα του Κώστα Βουλαζέρη 	prose
 «Ένα Τρένο με Πολύχρωμες Γυναίκες» – Διήγημα του Κώστα Βουλαζέρη 	prose
 «Ταξιδιώτης από το παρελθόν» – Διήγημα του Μάριου Μητσόπουλου 	prose
 «Το πέταγμα των δράκων» – Διήγημα του Μάριου Μητσόπουλου 	prose
 «Το πάρτι των νεκρών» – Διήγημα του Ερρίκου Καλύβα 	prose
 «Mundus» – Συλλογή ιστοριών του Μάριου Μητσόπουλου 	prose
 «Σκιές του παρελθόντος» – Διήγημα της Νατάσσας Θάνου 	prose
 «Η μάσκα της χαράς!» – Διήγημα της Νατάσσας Θάνου 	prose
"Acid Treep" - Γιάννης Τζανης	prose
 «Δέκα διάλογοι κι ένας μονόλογος» – Συλλογή του Βασίλη Κ. Αθανασιάδη 	prose
 «Ο Ξένος» – Τα 14 βραβευμένα διηγήματα του Δ ‘ Διαγωνισμού  “Στέλιος Ξεφλούδας” 	prose
 «Το γάλα των παιδιών και άλλα διηγήματα» του Χρήστου Γεωργιάδη 	prose
 «Τα είδωλα ξαναστήνονται τη νύχτα» – Διηγήματα του Κώστα Πουλιανίτη 	prose
"Σύνεργα' - Ευάγγελος Τζάνος	prose
 «Οι πρώτες σελίδες» – Συλλογή διηγημάτων του Χάρη Γαντζούδη 	prose
 «Το ταξίδι ενός χαρτονομίσματος» – Διηγήματα // συλλογικό έργο 	prose
 «Τα πέτρινα Χριστούγεννα» – Οπτικοποιημένο αφήγημα του Τάσου  Αγγελίδη-Γκέντζου 	prose
 «Μαζί» – Συλλογή διηγημάτων της Ευρυδίκης Αμανατίδου & του Γιάννη Λαμπράκη 	prose
 «Ιστορίες από ένα παγκάκι» – Διηγήματα // Συλλογικό έργο 	prose
 «Ένα ταξίδι… αλλιώς» – Διηγήματα // Συλλογικό έργο 	prose
 «Και μετά θα ζήσω τη ζωή μου» – Συλλογή διηγημάτων της Μαρίνας Αποστόλου 	prose
"Και αν;" - Ελευθερία Πασσά	prose
 «Θύτες και θύματα» – Συλλογή διηγημάτων της Ιφιγένειας Φασφαλή 	prose
"Δίνη" - Στέλλα ασημακοπούλου	prose
 «Τεθλασμένη ζωή» – Συλλογή διηγημάτων της Άννας Δεληγιάννη-Τσιουλπά 	prose
"Αναχώρηση" - Νίκος Σουβατζής	prose
 «Γαλήνης πλάσματα» – Συλλογή διηγημάτων του Ανδρέα Ανδρέου – Παπαπέτρου 	prose
 «Το Τέρας» – Συλλογή διηγημάτων του Απόστολου Λαγαρία 	prose
 «Ιστορίες δυο σελίδων» – Συλλογή διηγημάτων του Θανάση Μπατσακίδη	prose
 «Ακαδημίας 58α» – Διήγημα του Δημήτριου Κανελλόπουλου	prose
 «Γαλανή και Λεύκιος» – Διηγήματα του Λάκη Φουρουκλά 	prose
 «Τα ίχνη των ονείρων» – Διήγημα του Θάνου Μαντζάνα 	prose
 «Η εξομολόγηση μιας κάμερας» – Διήγημα του Αρχοντή Χρυσουλά 	prose
 «Ο πορτιέρης» – Διήγημα του Αρχοντή Χρυσουλά 	prose
 «Τα Μεταμεσονύχτια» – Μικρές ιστορίες της Σοφίας Γκιούσου 	prose
 «Σκόνη στον Καθρέφτη» – Διηγήματα του Αχιλλέα Ε. Αρχοντή 	prose
 «Ασσασίνοι του Βορρά Δροσουλίτες του Νότου»  – Διηγήματα του Τέου Ρόμβου 	prose
 «Δέκα μονόλογοι, ένας διάλογος» – Διηγήματα του Βασίλη Κ. Αθανασιάδη 	prose
 «Κύκλοι στη θάλασσα… και άλλες ιστορίες» – Διηγήματα του Χάρη Γαντζούδη 	prose
"Δύο Θέματα και Ένα σεμινάριο" - Βασίλης Αθανασιάδης	prose
 «Σφηνοειδείς γραφές» – Πεζογράφημα του Απόστολου Σπυράκη 	prose
 «Στην οδό Ευμολπιδών» – Διήγημα του Ευάγγελου Τζάνου 	prose
 «Το πράσινο ποτάμι» – Διήγημα επιστημονικής φαντασίας του Νίκου Φάκου 	prose
"Δείπνο για 4" - Γιάννης Τζανής	prose
 «Η επόμενη στροφή» – Διήγημα της Κατερίνας Τζωρτζακάκη 	prose
 «Ο θησαυρός της γιαγιάς» – Διήγημα της Σμαραγδής Μητροπούλου 	prose
 «Ο Τίποτας» – Διήγημα της Αντιγόνης Σώρρου 	prose
 «Εγώ και εσύ» – Διήγημα του Κώστα Χαραλάμπους & της Γεωργίας Κολοβελώνη 	prose
"Καφέ" - Βαγγέλης & Κώστας Θερμογιάννης	prose
 «Εσωτερικός μετανάστης στο Εξωτερικό» – Διήγημα της Άννας  Δεληγιάννη Τσιουλπά 	prose
 «Ιστορίες με δύο όψεις» – Συλλογικό έργο 	prose
 «WebEx – Συχνά Ερωτήματα και Απαντήσεις» – Εγχειρίδιο του Πανελλήνιου  Σχολικού Δικτύου 	manual
 «Μικρός Οδηγός Webex για εκπαιδευτικούς» – Εγχειρίδιο της  Γεωργίας Τσακαλογιάννη 	manual
 «Microsoft Forms» – Εγχειρίδιο του Γεώργιου Φιλιππούση 	manual
 «Εργαλεία Web 2.0 για την Εκπαίδευση» – Εγχειρίδιο χρήσης για τον εκπαιδευτικό 	manual
 «Συνήθεις ερωτήσεις και οι απαντήσεις τους» – Εγχειρίδιο  για το ψάρεμα του Μιχάλη Μαντά 	manual
 «Παίζω και προγραμματίζω με το ρομπότ Thymio» – Εγχειρίδιο της  Ναταλίας Θεόκλειας Γεωργιτζίκη 	manual
 «Η μηχανή αναζήτησης της Google» – Εγχειρίδιο του Νίκου Κακλαμάνου 	manual
 “Το καλύτερο Antivirus του υπολογιστή σου… Είσαι εσύ” –  Εγχειρίδιο του Άκη Αρμόδιου 	manual
 “Εφαρμοσμένη Πληροφορική” – Εγχειρίδιο του Άκη Αρμόδιου 	manual
 “Εγχειρίδιο σχετικά με την ευρωπαϊκή νομοθεσία για την προστασία  των προσωπικών δεδομένων” 	manual
 “Δημιουργώ με το Arduino και προγραμματίζω με το Ardublock” –  Εγχειρίδιο της Ναταλίας Θεόκλειας Γεωργιτζίκη 	manual
 “ANARCHESS – Οι κανόνες του παιχνιδιού” – Εγχειρίδιο του Δημήτρη Γραμμένου 	manual
 “HTML5+JavaScript: Δημιουργώντας παιχνίδια – Ο εύκολος τρόπος”  – Εγχειρίδιο του Κωνσταντίνου Παπαστεργίου 	manual
 “Κώδικας Δεοντολογίας Εθελοντών Ανθρωπιστικού Χαρακτήρα” –  Εγχειρίδιο του Αναστάσιου Γ. Γερασιμάτου 	manual
 “Πορτοκαλί Οικονομία / Μια διαρκής ευκαιρία” – Εγχειρίδιο του Felipe  Buitrago Restrepo 	manual
 “Εγχειρίδιο ενεργειών για την οργάνωση καθαριότητας Ακτών και Θαλασσών”  – Αναστάσιος Γ. Γερασιμάτος 	manual
 “Η Pascal με παραδείγματα” – Εγχειρίδιο του Γιώργου Χατζηκυριάκου 	manual
 “Εγχειρίδιο Πρώτων Βοηθειών” – Εθνικό Κέντρο Άμεσης Βοήθειας (ΕΚΑΒ) 	manual
 «Εγχειρίδιο Πράσινων Πρακτικών για Μικρές και Μεσαίες Επιχειρήσεις» 	manual
 “Εισαγωγή στη Φωτογραφία” – Εγχειρίδιο του Ανδρέα Κατσικούδη 	manual
 “Ξεκινώντας με το Ubuntu 10.04” – Εγχειρίδιο χρήσης 	manual
 “Ανάπτυξη και εικαστικός σχεδιασμός ιστοτόπων” – Εγχειρίδιο επιμορφωτή 	manual
 “Visual Basic: Εκπαιδευτικό εγχειρίδιο” – Getting started 	manual
 Ανοικτό Σπηλαιολογικό Εγχειρίδιο 	manual
 “Εγχειρίδιο εκμάθησης της Ελληνικής Γλώσσας σε Μετανάστες και Πρόσφυγες” 	manual
 “Ζώντας με τον HIV” – Εγχειρίδιο 	manual
 “Ας μιλήσουμε ξεκάθαρα για την ακροδεξιά” – Εγχειρίδιο του Κωστή Παπαϊωάννου 	essay
 “Μαθήματα Φωτογραφίας” – Εγχειρίδιο της Λέσχης Φωτογραφίας &  Κινηματογράφου Καρδίτσας 	manual
 “Εισαγωγή στον προγραμματισμό με την Python” – Εγχειρίδιο του Μανώλη Κιαγιά 	manual
 “Επικοινωνιακή Διαχείριση Κρίσεων” – Εγχειρίδιο του Ιωάννη Σταμούλη 	manual
 “Μαθαίνω Ελληνικά” – Εγχειρίδιο του Παντελή Παππά 	manual
 “LabVIEW: Εκπαιδευτικό εγχειρίδιο” – Τετράδιο μαθητή 	manual
 “Visual Basic: Εκπαιδευτικό εγχειρίδιο” – Βιβλίο καθηγητή 	manual
 “LabVIEW: Εκπαιδευτικό εγχειρίδιο” – Getting started 	manual
 “Εκπαίδευση στα λογισμικά: Adobe Premiere Pro CS3 και Visual Basic” –  Εγχειρίδιο επιμορφούμενου 	manual
 “Εκπαίδευση στα λογισμικά Adobe Premiere Pro CS3 και Visual Basic” –  Εγχειρίδιο επιμορφωτή 	manual
 “MultiSIM: Εκπαιδευτικό εγχειρίδιο” – Τετράδιο μαθητή 	manual
 “JAVA: Εκπαιδευτικό εγχειρίδιο” – Τετράδιο μαθητή 	manual
 “CorelDraw X4: Εκπαιδευτικό εγχειρίδιο” – Τετράδιο μαθητή 	manual
 “CorelDRAW X4: Εκπαιδευτικό εγχειρίδιο” – Βιβλίο καθηγητή 	manual
 “Quark: Εγχειρίδιο εγκατάστασης QuarkXPress & QLA Server” 	manual
 “Εκπαιδευτικό Εγχειρίδιο για Ενδυνάμωση των Νέων για την Πρόληψη  της Έμφυλης Βίας μέσω Αλληλοδιδακτικής Προσέγγισης” 	manual
οι άδειες creative commons	manual
 “Ξέρω να προστατευτώ όταν γίνεται σεισμός” – Εγχειρίδιο της Φρίντας Κριτσωτάκη 	manual
 “Εφαρμοσμένες γλωσσικές δραστηριότητες” – Εγχειρίδιο για το νηπιαγωγείο 	manual
 Λογισμικά: “Τα Τρόφιμα – Οδηγός Καλλωπιστικών Φυτών” –  Εγχειρίδιο επιμορφωτή 	manual
 «Πώς γράφω λήμματα στην Βικιπαίδεια» 	manual
 «Μερικά εύκολα βήματα για να βοηθήσετε το παιδί σας να γίνει Ψηφιακός Πολίτης» 	manual
 «Οδηγός για γονείς-κηδεμόνες για σωστή και ασφαλή φοίτηση  των παιδιών στα σχολεία» 	manual
 «Οδηγός προγράμματος Erasmus+ 2020» 	manual
 «Βασικά Θέματα Πληροφορικής» 	manual
«Αναρρίχηση στον Άγιο Πέτρο Αρκαδίας»	manual
 «Κυνηγετικός Οδηγός» 	manual
 “Εποπτεία & Ασφάλεια λουόμενων και χώρου ευθύνης από τον Επόπτη  ασφαλείας κολυμβητικών δεξαμενών” – Αναστάσιος Γ. Γερασιμάτος 	manual
 “Το τετράδιο της Wikipedia” – Σύντομος οδηγός συγγραφής άρθρων 	manual
 «Οδηγός εφαρμογής & λειτουργίας Κέντρων Κοινότητας» 	manual
 “Μια τάξη στο διαδίκτυο – Η πλατφόρμα EdModo” 	manual
 “Προγραμματισμός σε App Inventor” 	manual
 “Εισαγωγή στις Αρχές της Επιστήμης των Η/Υ” 	manual
 “Προγραμματισμός με Python στο Raspberry Pi” 	manual
 “Το Μανιφέστο των Ψηφιακών δεξιοτήτων” 	manual
 “Computer Masti” – Βιβλίο δραστηριοτήτων ΙΙΙ 	manual
 “Computer Masti” – Βιβλίο δραστηριοτήτων Ι 	manual
 “Η εξ αποστάσεως εκπαίδευση στην εκπαίδευση ενηλίκων” –  Παραδείγματα και περιπτώσεις εφαρμογής 	manual
 “Διδακτική στην εκπαίδευση ενηλίκων” 	manual
 “Προγραμματίζοντας με τον μικροελεγκτή Arduino” 	manual
φωτογραφία	manual
 “ΑΒΓ – Το αλφαβητάρι του Διαδικτύου” 	manual
 “Οδηγός Δημιουργίας Κοινωνικών Επιχειρήσεων” 	manual
 “Καλώς ήλθατε στη Γερμανία” – Πληροφορίες για μετανάστες 	manual
 “Ταξίδι στη γλώσσα” 	manual
 “Ελάτε να υφάνουμε” – Φυλλάδιο για τα εκπαιδευτικά προγράμματα  του Μουσείου Μετάξης 	manual
 Τα ανθρώπινα δικαιώματα σου – Ένας οδηγός για ηλικιωμένα άτομα 	manual
 «Ο Κόσμος στο Κατώφλι μας» – Εγχειρίδιο Εκπαιδευτικού 	manual
 “Οδηγός Λειτουργιών του Firefox OS” 	manual
 “Τα πρώτα σας βήματα στη Ζυρίχη” 	manual
 “Πρόληψη – Αντιμετώπιση Πυρκαγιών” – Πυροσβεστικό Σώμα Ελλάδας 	manual
 “Ηλεκτρονική Ενσωμάτωση & Ψηφιακός Αλφαβητισμός στην Ελλάδα” 	manual
 “Web 2.0: Χαρακτηριστικά και επίδρασή του σε επιχειρήσεις,  κεντρική διοίκηση και χρήστες” 	manual
 “Το Scratch πάει Δημοτικό!” – Προτάσεις αξιοποίησης στην Πρωτοβάθμια  Εκπαίδευση 	manual
 “Κατασκευή δικτυακού τόπου με το WordPress” 	manual
 “Φύλλο Εργασίας VOKI” 	manual
 “Όνειρο για να λερώσει το άσπρο” – Ποιητική συλλογή της Εύης Λάσκαρη-Τσάγκα 	poem
 “Δημιουργία ιστοσελίδας με WordPress” – Βασικές λειτουργίες 	manual
 “Ελληνικός οδηγός Mozilla Thunderbird” 	manual
 “Οδηγίες για την αφαίρεση των γκράφιτι” – Δήμος Αθηναίων 	manual
 “Σχέδια Εκκένωσης Κρίσιμων Υποδομών σε περίπτωση Σεισμού ή Πυρκαγιάς  για Άτομα με Αναπηρία” 	manual
 “Μαθαίνω τι να κάνω στον σεισμό (με νοήματα και σύμβολα ΜΑΚΑΤΟΝ)” – ΑμεΑ 	manual
 “FAQ – Συχνές ερωτήσεις και απαντήσεις για την ασφαλή χρήση του Διαδικτύου” 	manual
 “Προστασία της ιδιωτικής μας σφαίρας στο Facebook” 	manual
 “Εκπαιδευτικά μονοπάτια στο Διαδίκτυο” – Οδηγός για γονείς 	manual
 “Facebook – Σκεφτείτε καλά πριν κοινοποιήσετε” 	manual
 “Grooming – Η αποπλάνηση μέσω διαδικτύου” 	manual
 “Sexting” 	manual
 “Συμβουλές για Ασφάλεια στα Κοινωνικά Δίκτυα” 	manual
 “Συμβουλές για Ασφάλεια στο Instagram” 	manual
 “Συμβουλές για ασφάλεια στο Snapchat” 	manual
 “Οδηγός Facebook” 	manual
 “Οδηγός Παράνομου Περιεχομένου” 	manual
 “Οδηγός Ασφαλούς Πλοήγησης” 	manual
 “SearchCulture.gr: Μία Πρότυπη Πλατφόρμα Συσσώρευσης &  Αναζήτησης Πολιτιστικού Περιεχομένου” 	manual
 “Semantics.gr: Το Ενιαίο Σύστημα Σημασιολογικών Λεξιλογίων” 	manual
 “Παιδαγωγική αξιοποίηση των Τεχνολογιών της Πληροφορίας και Επικοινωνιών” 	manual
 “Γενικές αρχές της οργάνωσης και διοίκηση της Εκπαίδευσης” 	manual
 “Οδηγός Ολοήμερου Νηπιαγωγείου” 	manual
“Διαχείριση ανθρώπινων πόρων στο χώρο της εκπαίδευσης”	manual
 “Προσομοίωση Αναλογικών και Ψηφιακών Κυκλωμάτων με την βοήθεια του  ΤinaPro και Τρισδιάστατη Σχεδίαση με το AutoCAD” 	manual
 “SingularLogic Accountant: To απόλυτο εργαλείο του σύγχρονου λογιστή” 	manual
 “Adobe Photoshop CS3” – Τετράδιο μαθητή 	manual
 “Adobe Photoshop CS3” – Βιβλίο καθηγητή 	manual
 “Adobe Flash CS3” – Τετράδιο μαθητή 	manual
 “Adobe Flash CS3” – Βιβλίο καθηγητή 	manual
 “Adobe Dreamweaver CS3” – Τετράδιο μαθητή 	manual
 “Adobe Dreamweaver CS3” – Βιβλίο καθηγητή 	manual
 “EAGLE: Τετράδιο μαθητή” 	manual
 “Εκπαίδευση στα Λογισμικά “Real Nursing Skills – Pediatric Nursing Skills”  και “Fundamentals of Nursing”” 	manual
 “Θρεπτική και ενεργειακή αξία των τροφίμων – Τα Καλλωπιστικά Φυτά” – Λογισμικό 	manual
 “Ανάπτυξη και εικαστικός σχεδιασμός ιστοτόπων” – Εγχειρίδιο επιμορφωτή 	manual
 “Οδηγός λογισμικού key-book+ ΜικροΟικονομία” 	manual
 “Διοίκηση ολικής ποιότητας στις δημόσιες υπηρεσίες και στο χώρο της εκπαίδευσης” 	manual
 “Εκσυγχρονισμός της Δημόσιας Διοίκησης” 	manual
“Εκπαιδευτική νομοθεσία”	manual
 “Σύστημα αξιολόγησης και πιστοποίησης γλωσσομάθειας” 	manual
 “Διδακτικές προτάσεις για το μάθημα της λογοτεχνίας” 	manual
 “Βιβλίο που μιλάει για την Τεχνολογία” 	manual
 “Ασκήσεις για την Τεχνολογία” 	manual
 “Το πλαίσιο της τεχνολογικής εξέλιξης – Κοινωνικό περιβάλλον και τεχνολογία” 	manual
 “Διαπολιτισμικό σχέδιο εργασίας: Πρόσφυγες” 	manual
 “Η οικογένεια στην οδό Φιλίας” 	manual
 “Εγώ, εμείς και η Ευρώπη” 	manual
 “Κείμενα για νέους σε απλά Ελληνικά: Βιβλίο Γ'” 	manual
 “Κείμενα για νέους σε απλά Ελληνικά: Βιβλίο Δ'” 	manual
 “Κόσμοι της Φυσικής: Θερμόμετρα, φωτεινές ακτίνες και ηλεκτρικά κυκλώματα:  Οδηγίες για τον εκπαιδευτικό” 	manual
 “Κόσμοι της Φυσικής: Θερμόμετρα, φωτεινές ακτίνες και ηλεκτρικά κυκλώματα:  Βιβλίο Δραστηριοτήτων” 	manual
 “Βήματα στον κόσμο: Επικοινωνώ” – Ενότητα 2 	manual
 “Βήματα στον κόσμο: Επικοινωνώ” – Ενότητα 4 	manual
 “Βήματα στον κόσμο: Περιγράφω” – Ενότητα 1 	manual
 “Βήματα στον κόσμο: Περιγράφω μια διαδικασία” – Ενότητα 1 	manual
 “Βήματα στον κόσμο: Περιγράφω μια διαδικασία” – Ενότητα 2 	manual
 “Βήματα στον κόσμο: Περιγράφω μια διαδικασία” – Ενότητα 4 	manual
 “Διαβάζω 1” 	manual
 “Διδάσκοντας Λογοτεχνία στο Γυμνάσιο: Προτάσεις για την αξιοποίηση  του διδακτικού υλικού” 	manual
 “Διδάσκοντας Ιστορία στο Γυμνάσιο: Προτάσεις για την αξιοποίηση του  διδακτικού υλικού” 	manual
 “Διδάσκοντας Νεοελληνική Γλώσσα στο Γυμνάσιο: Προτάσεις για την  αξιοποίηση του διδακτικού υλικού” 	manual
 “Γεια σας 2: Το σχολείο μου” – Βιβλίο μαθητή 	manual
 «Γεια σας 4: Η καθημερινή μου ζωή» – Βιβλίο μαθητή 	manual
 “Διηγούμαι και γράφω ιστορίες (Αναδιήγηση): Ενότητα 5” 	manual
 “Κλειδιά και αντικλείδια: Στερεότυπα και προκαταλήψεις” 	manual
 “Κλειδιά και αντικλείδια: Στερεότυπα και προκαταλήψεις” 	manual
 “Κλειδιά και αντικλείδια: Μουσική στο σχολείο” 	manual
 “Κλειδιά και αντικλείδια: Διαθεματική προσέγγιση της γνώσης” 	manual
 “Κλειδιά και αντικλείδια: Επικοινωνία και ταυτότητες σε μια πολύγλωσση οικογένεια” 	manual
 “Κλειδιά και αντικλείδια: Ταυτότητα και εκπαίδευση” 	manual
 “Κλειδιά και αντικλείδια: Η επανατροφοδότηση των μαθητών στα  γραπτά τους κείμενα” 	manual
 “Κλειδιά και αντικλείδια: Πολιτισμός και σχολείο” 	manual
 “Κλειδιά και αντικλείδια: Μαθαίνοντας και διδάσκοντας Μαθηματικά” 	manual
 “Κλειδιά και αντικλείδια: Η μειονοτική εκπαίδευση της Θράκης” 	manual
“Κλειδιά και αντικλείδια: Φυσικές Επιστήμες – διδασκαλία και εκπαίδευση” 	manual
 “Κλειδιά και αντικλείδια: Το λάθος ως εργαλείο μάθησης και διδασκαλίας” 	manual
 “Κλειδιά και αντικλείδια: Η επεξεργασία της εικόνας στη σχολική τάξη” 	manual
 “Κλειδιά και αντικλείδια: Η επικοινωνιακή προσέγγιση του γλωσσικού μαθήματος” 	manual
 “Κλειδιά και αντικλείδια: Κίνητρο στην εκπαίδευση” 	manual
 “Κλειδιά και αντικλείδια: Για τη μέθοδο project” 	manual
 “Προσαρμογές αναλυτικών προγραμμάτων για τα Μαθηματικά και τις Φυσικές  Επιστήμες στο Δημοτικό” – Σχέδια διδασκαλίας για μαθητές με μαθησιακές  δυσκολίες 	manual
 “Προσαρμογές αναλυτικών προγραμμάτων για το μάθημα της Γλώσσας  στο Γυμνάσιο: Διαθεματικό πλαίσιο και σχέδια διδασκαλίας (Τεύχος Α’)” 	manual
 “Προσαρμογές αναλυτικών προγραμμάτων για το μάθημα της  Γλώσσας στο Γυμνάσιο: Υποστηρικτικό υλικό (Τεύχος Β’)” 	manual
 “Εθνικά Συστήματα Προσόντων & Πλαίσια Δια Βίου Εκπαίδευσης” 	manual
 “Γενικοί Δείκτες Αξιολόγησης και Πιστοποίησης” 	manual
 “Βασικές Δεξιότητες στις Νέες Τεχνολογίες Ι” 	manual
 “Βασικές Δεξιότητες στις Νέες Τεχνολογίες ΙΙ” 	manual
 “Καινοτομία – Επιχειρηματικότητα – Επιχειρήσεις” 	manual
 “Συμβουλευτική κρατουμένων” 	manual
 “Εγώ, εσύ, εμείς” 	manual
 “Δημιουργική Σκέψη – Παραγωγή Καινοτόμων και Πρωτότυπων Ιδεών” 	manual
 “Οικογενειακός αριθμητισμός” 	manual
 “Εξειδικευμένες Δεξιότητες στις Νέες Τεχνολογίες” 	manual
 “Ακούγοντας μουσική” – Μια προσέγγιση μέσα από τον κόσμο των μεμβρανοφώνων 	manual
 “Αξιοποίηση υπηρεσιών Δημοσίου και Ιδιωτικού τομέα” 	manual
 “Δικαιώματα εργαζομένου” 	manual
 “Συμβουλευτική Προσφύγων, Παλιννοστούντων, Μεταναστών και Αιτούντων Άσυλο” 	manual
 “Οικονομική Διαχείριση και Χρήση Νέων Τεχνολογιών στη Διαχείριση Νοικοκυριού” 	manual
 “Συνοπτική Ιστορία της Ευρώπης και της Ευρωπαϊκής Ένωσης” 	manual
 “Χρήση Νέων Τεχνολογιών στις Επιχειρήσεις” 	manual
 “Οργάνωση και Διοίκηση Επιχειρήσεων” 	manual
 “Βιβλία – Βιβλιοθήκες” 	manual
 “Πληροφορική ΙΙI: Εισαγωγή σε Υπολογιστικά φύλλα – Παρουσιάσεις –  Βάσεις δεδομένων” 	manual
 “Ο Λιγνίτης στο Ελληνικό Ενεργειακό Σύστημα” 	manual
 “Ενδυνάµωση της Νεολαίας για την Πρόληψη της Έµφυλης Βίας µέσω  Αλληλοδιδακτικής Προσέγγισης” 	manual
 “Ελληνική Μετάφραση του OpenCart” – Οδηγός Χρήσης 	manual
 “Καταυλισμοί προσφύγων – Βασικές Αρχές Διαχείρισης” 	manual
 “Υλοποίηση Επιχειρησιακής Άσκησης Σεισμού σε τοπικό επίπεδο” 	manual
 Οδηγός Ανάπτυξης Διαθεματικών Δραστηριοτήτων Περιβαλλοντικής Εκπαίδευσης 	manual